######################################################################
#                                                                   ##
#                                                                   ##
#                                        #                          ##
#                                       #                           ##
############  CCCCCCCCCCCCCCCCC                                     ##
#                                    # #############      ############
#   h                               #  #############      ############
#  #####G#####S##                  #   ##############      ###########
#                                 #    #############      ############
#                                #     ############     ##############
#                h      #####G######################      ############
#                                      ###############      ##########
#          ############                #############      ############
#                     #                ##########       ##############
#   ####               #               #############      ############
#                       #              ###########     ###############
#       ####             #             #                             #
#                         #            #                             #
######################################################################
