##################################################
#                 #                              #
###               ###                            #
###              ###                  ####  #    #
####             ###                 ##        ###
####          ######      ############    ##     #
####            #######                       ####
##   # ## ###      # #  ##                       #
###    ### #  CCCCCCCCCCCCCCCCCCC                #
#                                                #
                                                 
########S######                ###################
#                                                #
#                                                #
#                                                #
#       ###      ###    #####          #         #
#         ########                     #         #
####                #            #  #            #
####               ###         # #               #
##################################################
